ad2xy.pro	wcs
add_distort.pro	wcs
adstring.pro	text
adxy.pro	wcs
airtovac.pro	time
aitoff.pro	map
aitoff_grid.pro	map
al_legend.pro	?
al_legendtest.pro	?
altaz2hadec.pro	wcs
aper.pro	phot
arcbar.pro	?
arrows.pro	?
asinh.pro	math
astdisp.pro	?
astro.pro	?
astrolib.pro	?
autohist.pro	plot
avg.pro	math
baryvel.pro	time
biweight_mean.pro	math
blink.pro	?
blkshift.pro	?
boost_array.pro	?
boxave.pro	math
bprecess.pro	?
break_path.pro	?
bsort.pro	math
calz_unred.pro	phot
ccm_unred.pro	phot
check_fits.pro	fits
checksum32.pro	file
cic.pro	?
cirrange.pro	?
cleanplot.pro	plot
cntrd.pro	?
co_aberration.pro	?
co_nutate.pro	?
co_refract.pro	?
compare_struct.pro	lang
concat_dir.pro	lang
cons_dec.pro	text
cons_ra.pro	text
convolve.pro	math
copy_struct.pro	lang
copy_struct_inx.pro	lang
correl_images.pro	plot
correl_optimize.pro	math
corrmat_analyze.pro	?
cosmo_param.pro	?
cr_reject.pro	?
create_struct.pro	lang
cspline.pro	math
ct2lst.pro	time
curs.pro	?
curval.pro	?
dao_value.pro	phot
daoerf.pro	phot
date.pro	time
date_conv.pro	time
daycnv.pro	time
db_ent2ext.pro	db
db_ent2host.pro	db
db_info.pro	db
db_item.pro	db
db_item_info.pro	db
db_or.pro	db
db_titles.pro	db
dbbuild.pro	db
dbcircle.pro	db
dbclose.pro	db
dbcompare.pro	db
dbcreate.pro	db
dbdelete.pro	db
dbedit.pro	db
dbedit_basic.pro	db
dbext.pro	db
dbext_dbf.pro	db
dbext_ind.pro	db
dbfind.pro	db
dbfind_entry.pro	db
dbfind_sort.pro	db
dbfparse.pro	db
dbget.pro	db
dbhelp.pro	db
dbindex.pro	db
dbmatch.pro	db
dbopen.pro	db
dbprint.pro	db
dbput.pro	db
dbrd.pro	db
dbsearch.pro	db
dbsort.pro	db
dbtarget.pro	db
dbtitle.pro	db
dbupdate.pro	db
dbval.pro	db
dbwrt.pro	db
dbxput.pro	db
dbxval.pro	db
delvarx.pro	lang
deredd.pro	phot
detabify.pro	?
dist_circle.pro	plot
dist_ellipse.pro	plot
eci2geo.pro	map
eq2hor.pro	map
eqpole.pro	map
eqpole_grid.pro	map
euler.pro	?
expand_tilde.pro	?
extast.pro	wcs
extgrp.pro	wcs
f_format.pro	?
factor.pro	?
fdecomp.pro	?
filter_image.pro	?
find.pro	phot
find_all_dir.pro	?
find_with_def.pro	?
findpro.pro	lang
fitexy.pro	?
fits_add_checksum.pro	fits
fits_ascii_encode.pro	fits
fits_cd_fix.pro	fits
fits_close.pro	fits
fits_help.pro	fits
fits_info.pro	fits
fits_open.pro	fits
fits_read.pro	fits
fits_test_checksum.pro	fits
fits_write.pro	fits
fitsdir.pro	fits
fitsrgb_to_tiff.pro	map
flegendre.pro	?
flux2mag.pro	phot
fm_unred.pro	phot
forprint.pro	text
frebin.pro	?
ftab_delrow.pro	fits
ftab_ext.pro	fits
ftab_help.pro	fits
ftab_print.pro	fits
ftaddcol.pro	fits
ftcreate.pro	fits
ftdelcol.pro	fits
ftdelrow.pro	fits
ftget.pro	fits
fthelp.pro	fits
fthmod.pro	fits
ftinfo.pro	fits
ftkeeprow.pro	fits
ftprint.pro	fits
ftput.pro	fits
ftsize.pro	fits
ftsort.pro	fits
fxaddpar.pro	fits
fxbaddcol.pro	fits
fxbclose.pro	fits
fxbcolnum.pro	fits
fxbcreate.pro	fits
fxbdimen.pro	fits
fxbfind.pro	fits
fxbfindlun.pro	fits
fxbfinish.pro	fits
fxbgrow.pro	fits
fxbheader.pro	fits
fxbhelp.pro	fits
fxbhmake.pro	fits
fxbintable.pro	fits
fxbisopen.pro	fits
fxbopen.pro	fits
fxbparse.pro	fits
fxbread.pro	fits
fxbreadm.pro	fits
fxbstate.pro	fits
fxbtdim.pro	fits
fxbtform.pro	fits
fxbwrite.pro	fits
fxbwritm.pro	fits
fxfindend.pro	fits
fxhclean.pro	fits
fxhmake.pro	fits
fxhmodify.pro	fits
fxhread.pro	fits
fxmove.pro	fits
fxpar.pro	fits
fxparpos.pro	fits
fxposit.pro	fits
fxread.pro	fits
fxwrite.pro	fits
gal_flat.pro	map
gal_uvw.pro	map
galage.pro	map
gaussian.pro	math
gcirc.pro	?
gcntrd.pro	?
geo2eci.pro	map
geo2geodetic.pro	map
geo2mag.pro	map
geodetic2geo.pro	map
get_coords.pro	coord
get_date.pro	time
get_equinox.pro	coord
get_juldate.pro	time
get_pipe_filesize.pro	?
getopt.pro	?
getpro.pro	?
getpsf.pro	phot
getrot.pro	?
gettok.pro	text
getwrd.pro	?
glactc.pro	coord
glactc_pm.pro	coord
group.pro	?
gsss_stdast.pro	wcs
gsssadxy.pro	wcs
gsssextast.pro	wcs
gsssxyad.pro	wcs
hadec2altaz.pro	time
hastrom.pro	?
hboxave.pro	math
hcongrid.pro
headfits.pro	fits
helio.pro	time
helio_jd.pro	time
helio_rv.pro	time
hermite.pro	?
heuler.pro	?
hextract.pro	?
hgrep.pro	?
histogauss.pro	?
hor2eq.pro	time
host_to_ieee.pro	?
hprecess.pro	?
hprint.pro	?
hrebin.pro	?
hreverse.pro	?
hrot.pro	?
hrotate.pro	?
ieee_to_host.pro	?
imcontour.pro	plot
imdbase.pro	?
imf.pro	?
imlist.pro	?
irafdir.pro	text
irafrd.pro	text
irafwrt.pro	text
is_ieee_big.pro	lang
isarray.pro	lang
ismeuv.pro	lang
jdcnv.pro	time
jplephinterp.pro	?
jplephread.pro	?
jplephtest.pro	?
jprecess.pro	?
juldate.pro	time
ksone.pro	?
kstwo.pro	?
kuiperone.pro	?
kuipertwo.pro	?
lineid_plot.pro	?
linmix_err.pro	?
linterp.pro	?
list_with_path.pro	?
lsf_rotate.pro	?
lumdist.pro	?
mag2flux.pro	phot
mag2geo.pro	phot
make_2d.pro	?
make_astr.pro	wcs
match.pro	math
match2.pro	math
max_entropy.pro	?
max_likelihood.pro	?
meanclip.pro	math
medarr.pro	math
medsmooth.pro	math
minf_bracket.pro	?
minf_conj_grad.pro	?
minf_parabol_d.pro	?
minf_parabolic.pro	?
minmax.pro	math
mkhdr.pro	fits
mlinmix_err.pro	math
mmm.pro	phot
modfits.pro	fits
month_cnv.pro	time
moonpos.pro	time
mphase.pro	time
mrandomn.pro	math
mrd_hread.pro	fits
mrd_skip.pro	fits
mrd_struct.pro	fits
mrdfits.pro	fits
multinom.pro	?
multiplot.pro	plot
mwrfits.pro	fits
n_bytes.pro	lang
ngp.pro	?
nint.pro	lang
nstar.pro	phot
nulltrim.pro	text
nutate.pro	?
observatory.pro	wcs
one_arrow.pro	plot
one_ray.pro	plot
oploterror.pro	plot
ordinal.pro	?
partvelvec.pro	?
pca.pro	math
pent.pro	?
permute.pro	?
pixcolor.pro	?
pixwt.pro	?
pkfit.pro	?
planck.pro	?
planet_coords.pro	wcs
ploterror.pro	plot
plothist.pro	plot
plotsym.pro	plot
poidev.pro	?
polint.pro	?
polrec.pro	?
poly_smooth.pro	math
polyleg.pro	math
posang.pro	?
positivity.pro	?
precess.pro	?
precess_cd.pro	wcs
precess_xyz.pro	wcs
premat.pro	?
prime.pro	?
print_struct.pro	lang
prob_ks.pro	?
prob_kuiper.pro	?
psf_gaussian.pro	phot
putast.pro	?
qdcb_grid.pro	?
qget_string.pro	?
qsimp.pro	?
qtrap.pro	?
quadterp.pro	?
query_irsa_cat.pro	catalog
querydss.pro	catalog
querygsc.pro	catalog
querysimbad.pro	catalog
queryvizier.pro	catalog
radec.pro	coord
randomchi.pro	?
randomdir.pro	?
randomgam.pro	?
randomp.pro	?
randomwish.pro	?
rdfits_struct.pro	fits
rdfloat.pro	?
rdplot.pro	?
rdpsf.pro	?
read_fmr.pro	?
read_ipac_table.pro	catalog
read_ipac_var.pro	catalog
read_key.pro	?
readcol.pro	text
readfits.pro	fits
readfmt.pro	text
recpol.pro	?
rem_dup.pro	?
remchar.pro	?
remove.pro	?
repchr.pro	?
repstr.pro	?
resistant_mean.pro	?
rhotheta.pro	?
rinter.pro	?
rob_checkfit.pro	?
robust_linefit.pro	?
robust_poly_fit.pro	?
robust_sigma.pro	?
safe_correlate.pro	?
select_w.pro	?
sigma_filter.pro	?
sigrange.pro	?
sip_eval.pro	?
sixlin.pro	?
sixty.pro	time
sky.pro	phot
skyadj_cube.pro	?
solve_astro.pro	?
spec_dir.pro	?
sphdist.pro	?
srcor.pro	?
st_diskread.pro	?
starast.pro	?
store_array.pro	?
str_index.pro	?
strcompress2.pro	?
strn.pro	text
strnumber.pro	text
substar.pro	?
sunpos.pro	time
sunsymbol.pro	plot
sxaddhist.pro	fits
sxaddpar.pro	fits
sxdelpar.pro	fits
sxginfo.pro	fits
sxgpar.pro	fits
sxgread.pro	fits
sxhcopy.pro	fits
sxhmake.pro	fits
sxhread.pro	fits
sxhwrite.pro	fits
sxmake.pro	fits
sxopen.pro	fits
sxpar.pro	fits
sxread.pro	fits
sxwrite.pro	fits
t_aper.pro	phot
t_find.pro	phot
t_getpsf.pro	phot
t_group.pro	phot
t_nstar.pro	phot
t_substar.pro	phot
tabinv.pro	?
tag_exist.pro	?
tbdelcol.pro	?
tbdelrow.pro	?
tbget.pro	?
tbhelp.pro	?
tbinfo.pro	?
tbprint.pro	?
tbsize.pro	?
tdb2tdt.pro	?
ten.pro	time
tenv.pro	?
textclose.pro	?
textopen.pro	?
tic_one.pro	?
ticlabels.pro	?
ticpos.pro	?
tics.pro	?
tnx_eval.pro	?
to_hex.pro	time
tpv_eval.pro	?
transform_coeff.pro	?
trapzd.pro	?
tsc.pro	?
tsum.pro	?
tvbox.pro	plot
tvcircle.pro	plot
tvellipse.pro	plot
tvlaser.pro	plot
tvlist.pro	plot
unzoom_xy.pro	?
update_distort.pro	?
uvbybeta.pro	catalog
vactoair.pro	time
valid_num.pro	?
vect.pro	?
vsym.pro	?
wcs_check_ctype.pro	wcs
wcs_demo.pro	wcs
wcs_getpole.pro	wcs
wcs_rotate.pro	wcs
wcssph2xy.pro	wcs
wcsxy2sph.pro	wcs
webget.pro	?
wfpc2_metric.pro	?
wfpc2_read.pro	?
where_tag.pro	?
wherenan.pro	?
write_ipac_table.pro	catalog
writefits.pro	fits
xdispstr.pro	?
xmedsky.pro	?
xy2ad.pro	wcs
xyad.pro	wcs
xyxy.pro	wcs
xyz.pro	wcs
ydn2md.pro	time
ymd2dn.pro	time
zang.pro	?
zbrent.pro	?
zenpos.pro	time
zoom_xy.pro	?
zparcheck.pro	?